20 20
5 3 0 0 0 0 0 0 0 6 0 2 0 1 0 0 0 0 0 0
0 3 3 3 3 3 3 3 3 3 3 3 3 3 3 3 3 3 0 0
0 3 0 0 0 0 0 0 5 0 0 0 0 0 0 0 0 3 2 0
0 3 4 0 2 0 1 0 0 0 1 0 0 0 4 0 0 3 0 0
0 3 3 0 6 0 0 2 0 0 0 5 0 0 0 0 6 3 0 0
0 0 3 0 0 4 0 0 1 0 5 4 0 0 5 0 0 3 1 0
0 0 3 0 0 0 0 0 0 0 0 0 1 0 4 0 0 3 0 0
0 0 3 3 3 3 3 3 0 7 0 0 0 0 0 5 0 3 0 0
0 0 0 0 0 0 0 3 0 0 0 0 0 0 0 0 0 3 2 0
0 0 0 4 0 0 0 3 0 2 0 4 0 2 2 0 0 3 1 0
6 0 5 0 6 0 0 3 0 0 0 0 0 0 0 0 6 3 0 6
0 0 0 0 0 0 0 3 3 3 0 4 0 0 0 0 3 3 4 0
0 0 4 0 5 0 0 0 0 3 0 0 0 0 4 0 3 0 0 0
0 0 0 0 0 0 4 0 0 3 0 0 0 5 0 0 3 0 2 0
0 0 0 4 0 0 0 0 5 3 0 0 0 0 0 0 3 0 0 0
0 0 0 0 0 1 0 0 0 3 0 0 4 0 0 0 3 0 0 0
0 0 4 0 0 0 5 4 0 3 3 3 3 3 3 3 3 0 2 0
0 0 0 0 6 0 0 0 0 0 0 5 0 0 0 0 6 0 1 0
0 0 1 0 0 2 0 0 0 0 0 0 0 4 0 0 0 0 2 0
0 0 0 5 0 0 0 0 0 6 0 0 0 0 0 0 0 0 0 0